overall_score,duration_score,deep_sleep_in_minutes,resting_heart_rate,restlessness,logId,dateOfSleep,duration,minutesAsleep,minutesAwake,minutesAfterWakeup,timeInBed,efficiency,deep,rem,wake,light
82,40,104,55,0.054001929,24557669295,11/8/19,31080000,454,64,0,518,98,104,109,64,241
76,37,74,53,0.0525,24568088329,11/9/19,24600000,367,43,3,410,97,74,39,43,254
86,41,96,53,0.042448174,24591118909,11/11/19,30360000,456,50,0,506,97,97,138,50,221
78,41,95,52,0.054080629,24620397191,11/12/19,30840000,452,62,0,514,97,95,82,62,275
76,39,71,52,0.06268081,24620397192,11/13/19,31080000,443,75,0,518,96,71,63,75,309
78,42,66,52,0.054822335,24629313502,11/14/19,30660000,447,64,0,511,97,67,56,64,324
80,44,87,53,0.049151028,24642856054,11/15/19,33720000,488,74,0,562,97,87,71,74,330
80,40,106,54,0.069600819,24653443687,11/16/19,29280000,426,62,5,488,95,106,89,62,231
55,25,39,55,0.115973742,24665658497,11/17/19,18960000,238,78,0,316,90,49,32,78,157
74,36,74,57,0.052415211,24677959808,11/18/19,29700000,416,79,1,495,96,74,46,79,296
88,45,132,56,0.052064632,24690222313,11/19/19,33780000,493,70,0,563,96,132,90,70,271
85,41,105,55,0.056547619,24704811691,11/20/19,30660000,444,67,7,511,97,105,101,67,238
84,43,121,55,0.082976903,24720082785,11/21/19,35400000,493,97,0,590,94,122,101,97,270
67,33,68,55,0.064564565,24739496011,11/22/19,21060000,306,45,1,351,97,68,40,45,198
85,41,113,57,0.09219191,24750473684,11/23/19,31860000,474,57,0,531,94,113,114,57,247
48,20,51,56,0.097345133,24762389261,11/24/19,16920000,235,47,10,282,90,51,30,47,154
89,46,92,59,0.050513023,24773265387,11/25/19,38760000,589,57,0,646,97,92,110,57,387
87,46,102,56,0.054318789,24787280516,11/26/19,33780000,510,53,0,563,96,102,95,53,313
81,40,81,56,0.06916996,24797261032,11/27/19,30660000,437,74,1,511,95,82,105,74,250
78,38,110,56,0.041237113,24813192830,11/28/19,27720000,397,65,0,462,96,110,56,65,231
80,40,70,56,0.049073064,24816794063,11/29/19,27960000,417,49,0,466,96,71,79,49,267
74,37,105,57,0.038510911,24832789478,11/30/19,23340000,357,32,0,389,97,105,91,32,161
85,41,112,58,0.04047384,24840278233,12/1/19,30720000,456,56,1,512,96,112,110,56,234
80,40,91,57,0.050200803,24850225725,12/2/19,30780000,431,82,0,513,94,91,86,82,254
88,42,142,55,0.052684904,24863363675,12/3/19,30720000,451,61,0,512,95,143,114,61,194
84,44,63,55,0.067144136,24885180630,12/4/19,33660000,482,79,0,561,96,64,106,79,312
75,36,103,55,0.055674518,24897470664,12/5/19,28680000,404,74,0,478,96,103,71,74,230
75,36,103,55,0.055674518,24897470664,12/5/19,28680000,404,74,0,478,96,103,71,74,230
63,31,28,56,0.080491132,24906019321,12/6/19,22560000,317,59,3,376,90,29,19,59,269
70,38,69,56,0.031290743,24920178889,12/7/19,23460000,363,28,4,391,97,69,60,28,234
54,20,59,58,0.065989848,24929281012,12/8/19,17700000,246,49,0,295,94,59,88,49,99
93,46,132,60,0.056179775,24940595750,12/9/19,35160000,529,57,0,586,96,132,129,57,268
80,37,71,58,0.06010929,24955222875,12/10/19,27420000,397,60,0,457,97,72,85,60,240
85,40,133,57,0.056657224,24968864039,12/11/19,32460000,466,75,0,541,94,133,135,75,198
83,40,70,57,0.051599587,24977713670,12/12/19,29220000,427,60,1,487,97,70,84,60,273
79,41,93,55,0.061412487,24992472662,12/13/19,30240000,428,76,0,504,97,93,83,76,252
88,45,95,56,0.043956044,25003613866,12/14/19,33240000,482,72,0,554,98,95,146,72,241
83,41,86,55,0.053106212,25013421504,12/15/19,30900000,439,76,0,515,97,86,83,76,270
77,40,70,55,0.05786802,25024291416,12/16/19,29520000,427,65,0,492,96,71,54,65,302
82,42,117,57,0.048216008,25037523694,12/17/19,31620000,468,59,0,527,98,117,81,59,270
86,42,120,57,0.073022312,25054524296,12/18/19,29940000,445,54,0,499,92,121,140,54,184
80,39,67,56,0.060832444,25069236727,12/19/19,28080000,418,50,0,468,95,67,76,50,275
67,35,80,57,0.036568214,25083460566,12/20/19,21300000,327,28,0,355,97,80,52,28,195
88,42,81,58,0.043254377,25095207998,12/21/19,29400000,446,44,0,490,97,81,108,44,257
87,41,103,58,0.054600607,25104272160,12/22/19,29640000,438,56,0,494,98,104,132,56,202
87,42,76,57,0.054054054,25117434287,12/23/19,30840000,439,75,0,514,96,76,100,75,263
78,37,79,57,0.074458058,25127634557,12/24/19,31920000,436,96,0,532,95,80,83,96,273
78,38,79,56,0.064436183,25137393783,12/25/19,24660000,376,35,4,411,96,79,69,35,228
80,40,75,58,0.073737374,25149562053,12/26/19,30180000,427,76,6,503,96,76,74,76,277
70,38,123,58,0.133393017,25161934339,12/27/19,33720000,472,90,0,562,88,123,93,90,256
85,41,100,59,0.060512821,25173332208,12/28/19,29220000,429,58,8,487,96,100,94,58,235
85,42,104,59,0.050359712,25185510805,12/29/19,29880000,445,53,0,498,95,104,80,53,261
85,44,98,59,0.059555556,25199464785,12/30/19,33900000,482,83,0,565,95,98,69,83,315
86,42,110,56,0.053318825,25217353110,12/31/19,28080000,420,48,0,468,96,110,83,48,227
62,27,55,58,0.05893186,25229351887,1/1/20,16560000,244,32,0,276,93,55,67,32,122
84,44,104,60,0.064888889,25240531257,1/2/20,33720000,486,76,0,562,94,104,110,76,272
85,43,122,59,0.098976109,25255559440,1/3/20,35400000,494,96,0,590,89,122,103,96,269
76,38,61,59,0.08973173,25269683889,1/4/20,32640000,453,91,0,544,89,61,67,91,325
76,38,61,59,0.08973173,25269683889,1/4/20,32640000,453,91,0,544,89,61,67,91,325
55,24,16,59,0.097415507,25287210896,1/5/20,15060000,214,37,0,251,93,17,37,37,160
59,21,55,62,0.102923977,25296670417,1/6/20,25620000,333,94,0,427,86,55,41,94,237
83,43,80,60,0.081900082,25313286393,1/7/20,36600000,510,100,0,610,93,80,109,100,321
88,44,122,59,0.073666384,25335933537,1/8/20,35400000,513,77,0,590,93,122,109,77,282
80,39,105,59,0.072604066,25355306338,1/9/20,32160000,444,92,0,536,92,106,94,92,244
78,39,75,59,0.087684729,25371912665,1/10/20,30600000,430,80,0,510,92,75,56,80,299
78,38,71,58,0.051762115,25384935788,1/11/20,28140000,409,60,0,469,98,72,84,60,253
75,35,89,59,0.052366566,25398649912,1/12/20,29760000,417,79,0,496,98,89,85,79,243
82,41,115,60,0.085255066,25412247503,1/13/20,42900000,590,125,0,715,95,115,113,125,362
77,41,66,60,0.067141404,25430231153,1/14/20,30300000,430,75,0,505,96,67,56,75,307
81,38,95,61,0.061293984,25447432922,1/15/20,26640000,398,46,0,444,95,96,83,46,219
87,46,126,61,0.045155221,25480489361,1/17/20,32820000,482,65,0,547,98,126,97,65,259
68,29,65,62,0.076190476,25490575439,1/18/20,29460000,380,111,0,491,92,66,49,111,265
68,34,44,61,0.049253731,25505039645,1/19/20,20820000,307,40,0,347,91,44,74,40,189
77,36,99,63,0.087266251,25518056227,1/20/20,33660000,464,97,0,561,92,99,84,97,281
89,42,120,61,0.061833689,25531200031,1/21/20,29340000,432,57,0,489,97,120,97,57,215
80,41,82,58,0.056622851,25547728178,1/22/20,29640000,440,54,0,494,97,82,91,54,267
84,40,107,58,0.069375619,25562874196,1/23/20,30240000,441,63,0,504,95,107,99,63,235
80,38,55,58,0.060200669,25578081183,1/24/20,26880000,405,43,0,448,98,55,91,43,259
77,35,121,58,0.061336254,25594100410,1/25/20,28320000,392,80,0,472,96,121,94,80,177
84,44,110,58,0.075504829,25606665471,1/26/20,35040000,486,98,0,584,96,110,79,98,297
83,38,91,58,0.050941307,25618667722,1/27/20,27600000,405,55,0,460,98,92,107,55,206
68,30,103,58,0.057985758,25636026784,1/28/20,29460000,396,95,0,491,95,103,44,95,249
75,36,86,57,0.059251559,25654029950,1/29/20,30240000,409,95,0,504,96,86,81,95,242
77,35,72,57,0.053724054,25676420525,1/30/20,24540000,362,47,0,409,95,72,98,47,192
84,40,69,58,0.053159478,25698593538,1/31/20,29880000,437,61,0,498,96,69,99,61,269
90,46,119,57,0.067532468,25711876439,2/1/20,34860000,522,59,0,581,94,119,161,59,242
67,33,84,57,0.171910112,25724963332,2/2/20,26880000,380,68,0,448,92,84,107,68,189
88,42,117,59,0.048929664,25737280538,2/3/20,31200000,447,73,0,520,97,117,120,73,210
88,42,117,59,0.048929664,25737280538,2/3/20,31200000,447,73,0,520,97,117,120,73,210
80,40,111,57,0.064577398,25749725664,2/4/20,31860000,454,77,0,531,94,111,107,77,236
83,41,86,57,0.062806673,25765893059,2/5/20,30540000,454,55,0,509,94,87,134,55,233
78,37,67,58,0.048837209,25782616438,2/6/20,26460000,387,54,0,441,97,67,67,54,253
85,45,82,58,0.057567317,25799440967,2/7/20,32280000,481,57,0,538,97,82,96,57,303
76,36,86,59,0.057497182,25812210490,2/8/20,26580000,387,56,0,443,96,86,83,56,218
84,42,122,59,0.050746269,25825785735,2/9/20,30120000,454,48,0,502,97,122,89,48,243
85,42,99,59,0.058222676,25838092062,2/10/20,29340000,445,44,0,489,96,99,145,44,201
83,40,99,59,0.066601371,25851374525,2/11/20,30600000,447,63,0,510,96,99,97,63,251
80,41,80,58,0.075433231,25866923863,2/12/20,29940000,430,69,1,499,96,81,82,69,267
80,40,103,58,0.084075173,25879492138,2/13/20,30720000,441,71,0,512,93,103,77,71,261
89,45,127,57,0.05803196,25895293560,2/14/20,35640000,530,64,0,594,96,127,150,64,253
71,34,56,57,0.067052023,25908450486,2/15/20,25920000,369,63,9,432,97,56,54,63,259
57,28,33,58,0.036175711,25921511175,2/16/20,12480000,176,32,0,208,97,33,18,32,125
80,41,66,60,0.044247788,25935644860,2/17/20,32280000,452,86,0,538,96,66,52,86,334
89,45,117,57,0.065018315,25948680681,2/18/20,33120000,480,72,0,552,93,117,151,72,212
81,41,89,56,0.057803468,25963994903,2/19/20,31320000,460,62,1,522,97,89,80,62,291
79,40,97,55,0.05320197,25981039894,2/20/20,30720000,441,71,0,512,96,97,49,71,295
81,42,70,55,0.073170732,26016150425,2/22/20,32640000,468,76,0,544,90,70,67,76,331
76,37,78,55,0.059737157,26028613587,2/23/20,25440000,374,50,0,424,96,78,50,50,246
82,44,61,56,0.063223508,26042341074,2/24/20,33660000,482,79,0,561,96,61,57,79,364
83,41,86,55,0.055500496,26057469565,2/25/20,30420000,448,59,0,507,95,86,113,59,249
71,31,65,56,0.061480552,26073401124,2/26/20,23880000,337,61,1,398,94,65,58,61,214
75,40,78,57,0.133485889,26090818638,2/27/20,39300000,508,147,0,655,87,79,47,147,382
81,39,117,57,0.093067426,26100050551,2/28/20,31560000,454,72,0,526,94,117,131,72,206
77,39,60,59,0.097184378,26118719654,2/29/20,33480000,466,92,0,558,93,61,76,92,329
57,25,56,58,0.065274151,26132654905,3/1/20,11460000,162,29,8,191,91,57,31,29,74
87,44,136,60,0.056171471,26144839236,3/2/20,40560000,598,78,0,676,94,137,92,78,369
79,41,68,57,0.070805044,26161486964,3/3/20,31020000,462,55,0,517,96,68,40,55,354
82,41,94,56,0.055276382,26174036989,3/4/20,30120000,444,58,0,502,97,95,56,58,293
82,41,94,56,0.055276382,26174036989,3/4/20,30120000,444,58,0,502,97,95,56,58,293
88,43,132,56,0.058504875,26188191473,3/5/20,28440000,436,38,6,474,97,133,110,38,193
74,34,74,57,0.074074074,26206247505,3/6/20,25500000,367,58,7,425,96,74,62,58,231
72,33,76,58,0.049122807,26217176441,3/7/20,25620000,366,61,0,427,94,76,39,61,251
57,26,48,57,0.061023622,26232597244,3/8/20,15360000,225,31,1,256,95,49,38,31,138
86,45,112,59,0.051344743,26245291369,3/9/20,36780000,547,66,0,613,96,112,103,66,332
86,44,96,60,0.070990359,26260549766,3/10/20,34200000,487,83,0,570,94,97,97,83,293
86,39,133,59,0.066985646,26276301388,3/11/20,32220000,452,85,0,537,96,133,127,85,192
90,46,118,58,0.055906222,26288677246,3/12/20,33900000,512,53,1,565,98,119,120,53,273
68,30,80,58,0.09833795,26306676546,3/13/20,22140000,309,60,0,369,95,81,28,60,200
80,41,140,57,0.04789272,26319805852,3/14/20,31800000,464,66,0,530,95,140,73,66,251
71,33,50,59,0.072153326,26330434754,3/15/20,26580000,375,68,7,443,95,50,44,68,281
94,47,137,59,0.042033236,26344729203,3/16/20,33060000,484,67,0,551,98,137,100,67,247
87,42,132,58,0.058309038,26359894201,3/17/20,30840000,467,47,1,514,95,132,125,47,210
82,42,132,60,0.055331992,26374029513,3/18/20,30660000,449,62,0,511,95,132,70,62,247
80,39,107,62,0.085714286,26388009851,3/19/20,30420000,427,80,0,507,94,107,86,80,234
86,41,136,62,0.062562066,26405074529,3/20/20,30720000,450,62,0,512,96,137,96,62,217
80,40,79,60,0.071494893,26417013188,3/21/20,32280000,476,62,0,538,95,80,62,62,334
79,37,86,58,0.084959816,26428306841,3/22/20,26100000,388,47,0,435,93,86,76,47,226
87,46,92,56,0.059674503,26443543725,3/23/20,33840000,503,61,0,564,96,92,86,61,325
83,45,89,56,0.065276519,26455193802,3/24/20,33060000,485,66,0,551,97,90,99,66,296
83,46,68,58,0.067101584,26467281126,3/25/20,32580000,489,54,0,543,96,68,55,54,366
78,37,88,59,0.05279831,26480264755,3/26/20,29220000,414,73,0,487,92,89,62,73,263
76,33,96,58,0.050292398,26491324901,3/27/20,25620000,368,59,5,427,97,97,90,59,181
81,41,64,58,0.049445005,26503441818,3/28/20,29700000,437,58,0,495,97,64,60,58,313
88,44,125,57,0.054945055,26529472619,3/30/20,35460000,521,70,0,591,96,126,93,70,302