overall_score,duration_score,deep_sleep_in_minutes,resting_heart_rate,restlessness,logId,dateOfSleep,duration,minutesAsleep,minutesAwake,minutesAfterWakeup,timeInBed,efficiency,deep,rem,wake,light
72,37,62,52,0.107628004,24605116778,11/12/19,29100000,409,76,0,485,91,62,62,76,285
74,42,72,51,0.072572038,24619240566,11/13/19,29040000,423,61,0,484,93,73,47,61,303
73,37,56,53,0.082529475,24629537286,11/14/19,27960000,402,64,0,466,94,57,58,64,287
76,40,70,51,0.082698585,24642696271,11/15/19,30000000,420,80,0,500,90,70,107,80,243
75,42,62,53,0.102336825,24655696518,11/16/19,37200000,516,104,0,620,91,62,72,104,382
83,45,84,54,0.105691057,24666667030,11/17/19,33180000,491,62,0,553,90,84,96,62,311
76,41,46,53,0.095904096,24676413873,11/18/19,30180000,431,72,0,503,92,46,60,72,325
66,37,74,52,0.113402062,24689343230,11/19/19,29340000,416,73,0,489,88,74,36,73,306
73,41,70,53,0.101554404,24703090834,11/20/19,29340000,423,66,0,489,90,70,76,66,277
73,41,63,55,0.082744702,24718836569,11/21/19,29700000,437,58,0,495,91,63,58,58,316
71,35,66,56,0.104568528,24737364324,11/22/19,29520000,417,75,11,492,95,67,70,75,280
79,45,61,55,0.068308181,24751559045,11/23/19,38640000,567,77,0,644,94,61,54,77,452
60,34,31,55,0.082758621,24759989126,11/24/19,21960000,324,42,7,366,94,31,26,42,267
77,40,39,59,0.079878665,24772750924,11/25/19,29820000,428,69,0,497,95,39,46,69,343
81,42,57,57,0.060988433,24786762017,11/26/19,29160000,433,53,0,486,94,58,75,53,300
76,41,63,55,0.075322101,24796686687,11/27/19,30720000,449,63,0,512,93,63,67,63,319
77,41,87,55,0.076076076,24808113226,11/28/19,29940000,442,57,0,499,90,87,77,57,278
68,35,15,54,0.068812431,24818660562,11/29/19,27000000,383,67,0,450,96,15,54,67,314
76,46,93,54,0.084315503,24827636725,11/30/19,33060000,499,52,3,551,94,94,55,52,350
78,42,48,56,0.090817356,24840185583,12/1/19,30540000,449,60,0,509,93,48,93,60,308
73,36,61,56,0.078534031,24851379856,12/2/19,28980000,411,72,5,483,94,62,48,72,301
69,37,61,54,0.093457944,24863076809,12/3/19,30300000,417,88,6,505,95,62,50,88,305
68,34,66,54,0.099685205,24884819051,12/4/19,28560000,400,76,0,476,95,67,79,76,254
74,42,45,54,0.074775673,24896338188,12/5/19,30840000,447,67,0,514,95,45,63,67,339
78,41,57,55,0.084422111,24908259986,12/6/19,30540000,440,69,2,509,93,57,83,69,300
73,36,56,54,0.071515152,24919819656,12/7/19,24720000,366,46,0,412,95,56,42,46,268
79,45,46,52,0.081952921,24929604298,12/8/19,34680000,502,76,0,578,93,47,48,76,407
74,41,67,53,0.077163712,24940641066,12/9/19,29940000,424,75,0,499,91,68,54,75,302
65,35,50,54,0.100893997,24955358947,12/10/19,23700000,347,48,0,395,93,50,50,48,247
65,35,50,54,0.100893997,24955358947,12/10/19,23700000,347,48,0,395,93,50,50,48,247
79,44,65,56,0.095439189,24967460099,12/11/19,35760000,516,80,0,596,92,65,90,80,361
74,42,51,56,0.069546891,24978474292,12/12/19,29160000,427,59,6,486,94,51,28,59,348
77,38,76,56,0.062567422,24992858512,12/13/19,28860000,410,71,3,481,96,76,44,71,290
72,37,56,55,0.084477297,25055615665,12/18/19,28680000,410,68,0,478,96,56,47,68,307
70,35,67,54,0.091194969,25069701660,12/19/19,28920000,404,78,0,482,92,68,43,78,293
62,36,82,54,0.166824645,25085069675,12/20/19,31620000,430,97,0,527,82,82,44,97,304
78,41,41,56,0.076923077,25095243998,12/21/19,29460000,433,58,0,491,96,41,57,58,335
67,39,106,53,0.138862102,25113248449,12/22/19,31260000,440,81,0,521,90,107,51,81,282
85,46,80,55,0.082608696,25116910326,12/23/19,35040000,518,66,7,584,94,80,72,66,366
62,32,68,52,0.112922002,25127024324,12/24/19,25740000,359,70,0,429,91,68,40,70,251
75,44,92,54,0.099585062,25139986673,12/25/19,36120000,521,81,0,602,94,93,31,81,397
80,43,92,55,0.08988764,25164708623,12/27/19,37560000,523,103,0,626,95,92,77,103,354
63,33,45,54,0.097007224,25173413607,12/28/19,29160000,399,87,14,486,94,45,5,87,349
74,45,56,54,0.087628866,25190947826,12/29/19,35460000,514,77,4,591,92,56,46,77,412
85,44,83,56,0.097601323,25200786971,12/30/19,36240000,524,80,15,604,96,83,127,80,314
85,46,76,54,0.065619224,25217621156,12/31/19,33780000,495,68,6,563,96,77,68,68,350
63,31,27,53,0.095112285,25235687156,1/1/20,22680000,324,54,8,378,91,28,78,54,218
75,38,43,55,0.06343714,25241745366,1/2/20,25980000,387,46,0,433,98,43,52,46,292
71,35,60,53,0.113084112,25271304800,1/4/20,32280000,426,112,0,538,92,61,54,112,311
73,42,68,51,0.081932773,25284236029,1/5/20,29040000,430,54,3,484,96,68,51,54,311
70,35,40,52,0.082706767,25297525148,1/6/20,27900000,399,66,0,465,91,40,69,66,290
66,34,47,52,0.083604777,25314381786,1/7/20,27960000,390,76,0,466,95,47,49,76,294
71,37,58,53,0.077085533,25336575804,1/8/20,29400000,413,77,0,490,93,59,47,77,307
77,42,67,53,0.085427136,25356162782,1/9/20,30060000,444,57,0,501,96,67,66,57,311
77,42,67,53,0.085427136,25356162782,1/9/20,30060000,444,57,0,501,96,67,66,57,311
72,41,75,52,0.077725118,25374341616,1/10/20,31920000,466,66,2,532,94,75,59,66,332
76,43,62,53,0.06690455,25387880415,1/11/20,35220000,480,107,5,587,97,62,66,107,352
52,27,33,55,0.145708583,25398758459,1/12/20,15600000,224,36,1,260,85,33,11,36,180
63,37,32,57,0.170135747,25411255861,1/13/20,33120000,454,98,0,552,85,32,66,98,356
73,39,40,59,0.149758454,25432470191,1/14/20,31020000,437,80,0,517,90,40,75,80,322
68,41,21,57,0.182303585,25446733264,1/15/20,39300000,536,119,0,655,85,22,85,119,429
76,40,52,57,0.099350046,25462227826,1/16/20,33060000,468,83,8,551,95,52,76,83,340
86,46,80,55,0.069877243,25479226191,1/17/20,31740000,480,49,0,529,95,80,60,49,340
88,45,91,53,0.091970803,25493194532,1/18/20,41760000,621,75,0,696,94,91,162,75,368
79,40,31,51,0.109677419,25503882703,1/19/20,32520000,470,72,0,542,94,31,111,72,328
77,41,71,49,0.081549439,25519957827,1/20/20,29400000,431,59,0,490,94,71,48,59,312
76,41,45,47,0.108891109,25532148446,1/21/20,30000000,447,53,0,500,92,45,119,53,283
76,45,96,48,0.073516386,25550444788,1/22/20,33840000,496,68,0,564,96,97,69,68,330
79,41,65,50,0.07120743,25564026334,1/23/20,29580000,431,62,3,493,97,65,83,62,283
68,34,71,50,0.067581837,25580502821,1/24/20,28500000,401,74,0,475,95,72,74,74,255
81,42,91,51,0.066009852,25593088473,1/25/20,30420000,458,49,0,507,96,91,99,49,268
69,38,59,51,0.080722892,25605676430,1/26/20,25440000,378,46,0,424,94,59,45,46,274
65,38,64,53,0.075117371,25620684571,1/27/20,25920000,386,46,0,432,91,64,5,46,317
68,32,45,55,0.072303922,25637442441,1/28/20,24540000,344,65,0,409,95,46,36,65,262
68,38,67,56,0.081877729,25660670215,1/29/20,28080000,405,63,6,468,92,67,30,63,308
63,31,35,58,0.079812207,25676265651,1/30/20,19800000,282,48,1,330,93,36,9,48,237
78,41,56,58,0.076555024,25697740876,1/31/20,32160000,467,69,0,536,93,57,24,69,386
82,45,91,56,0.081488043,25712974113,2/1/20,34140000,495,74,1,569,96,92,61,74,342
85,45,101,56,0.07850912,25726409657,2/2/20,38100000,565,70,0,635,95,101,111,70,353
78,41,48,57,0.069430052,25736970595,2/3/20,29040000,421,63,0,484,98,49,77,63,295
74,37,66,58,0.073917635,25751665539,2/4/20,28800000,415,65,0,480,95,66,38,65,311
75,39,60,57,0.066471163,25766044861,2/5/20,30720000,434,78,0,512,97,60,57,78,317
74,40,77,58,0.073926074,25782412752,2/6/20,30000000,427,73,0,500,98,77,21,73,329
74,40,86,58,0.086255924,25800076594,2/7/20,31620000,462,65,0,527,92,87,45,65,330
87,45,111,59,0.072819644,25813542360,2/8/20,36360000,535,71,0,606,94,111,110,71,314
87,45,111,59,0.072819644,25813542360,2/8/20,36360000,535,71,0,606,94,111,110,71,314
78,42,64,59,0.084681256,25824381899,2/9/20,31680000,468,60,0,528,96,64,55,60,349
73,38,75,59,0.080996885,25839200853,2/10/20,28860000,418,63,0,481,93,75,40,63,303
81,42,72,59,0.072477963,25852528540,2/11/20,31200000,461,59,0,520,90,72,81,59,308
72,39,43,58,0.103652517,25866655841,2/12/20,30360000,431,75,0,506,93,43,28,75,360
72,39,83,58,0.064446831,25879353993,2/13/20,27900000,416,49,0,465,96,84,27,49,305
62,37,12,59,0.070953437,25896043613,2/14/20,27120000,395,57,8,452,92,12,14,57,369
86,46,77,62,0.05258216,25909323567,2/15/20,32460000,487,54,0,541,98,77,61,54,349
81,41,31,60,0.081766917,25921507449,2/16/20,32400000,479,61,0,540,95,32,89,61,358
75,38,86,57,0.079581152,25935544067,2/17/20,28860000,420,61,0,481,94,86,65,61,269
70,41,65,57,0.082272282,25947815256,2/18/20,30600000,454,56,0,510,93,66,21,56,367
69,35,49,59,0.086866598,25964757873,2/19/20,28980000,409,74,8,483,95,49,38,74,322
76,37,68,59,0.078756477,25981209158,2/20/20,29100000,416,69,4,485,96,68,93,69,255
75,37,42,58,0.055627426,26002194338,2/21/20,23580000,358,35,1,393,96,42,52,35,264
71,41,61,58,0.076439791,26016417132,2/22/20,29040000,424,60,0,484,94,62,34,60,328
84,46,60,60,0.071244635,26030621079,2/23/20,35520000,522,70,3,592,98,60,74,70,388
79,42,90,58,0.104123711,26042561207,2/24/20,29820000,440,57,3,497,91,90,69,57,281
76,41,98,57,0.089581305,26060084602,2/25/20,30780000,446,67,7,513,95,98,57,67,291
70,33,70,56,0.072196621,26073306584,2/26/20,19560000,297,29,0,326,97,71,50,29,176
76,41,77,56,0.084199584,26089325653,2/27/20,29400000,423,67,1,490,92,77,24,67,322
72,42,64,55,0.077457795,26105794276,2/28/20,30180000,449,54,0,503,95,64,50,54,335
82,46,109,57,0.083196046,26119630601,2/29/20,36600000,549,61,5,610,97,109,42,61,398
79,44,88,56,0.091887417,26133078910,3/1/20,36360000,517,89,0,606,95,88,71,89,358
72,38,50,56,0.075245365,26144544457,3/2/20,28440000,407,67,0,474,94,50,25,67,332
69,37,71,55,0.089324619,26161394767,3/3/20,28200000,400,70,0,470,90,72,47,70,281
75,40,72,56,0.087388282,26173879486,3/4/20,30180000,436,67,0,503,94,72,75,67,289
75,40,70,56,0.068599034,26190481933,3/5/20,31800000,448,82,0,530,95,71,43,82,334
77,41,74,55,0.074871795,26204725934,3/6/20,29220000,431,56,4,487,96,75,53,56,303
73,41,81,54,0.087215064,26219032446,3/7/20,30720000,438,74,0,512,92,81,30,74,327
79,42,61,54,0.063851699,26230985507,3/8/20,29100000,436,49,0,485,96,61,74,49,301
67,33,40,54,0.071071071,26244543950,3/9/20,30240000,408,96,0,504,94,41,14,96,353
67,33,40,54,0.071071071,26244543950,3/9/20,30240000,408,96,0,504,94,41,14,96,353
75,41,47,54,0.067298578,26260917942,3/10/20,32460000,467,74,1,541,95,47,36,74,384
77,44,58,53,0.081444165,26278465038,3/11/20,36000000,513,87,1,600,94,58,61,87,394
76,40,77,54,0.081652257,26289851452,3/12/20,31380000,453,70,0,523,93,77,66,70,310
77,45,85,54,0.090909091,26308415189,3/13/20,34200000,497,73,0,570,94,86,74,73,337
79,44,84,56,0.074074074,26332760431,3/15/20,37380000,522,101,0,623,97,84,74,101,364
78,42,91,55,0.086458333,26345109700,3/16/20,29520000,424,68,0,492,96,91,51,68,282
77,42,77,54,0.061375661,26360190581,3/17/20,29040000,425,59,1,484,96,77,54,59,294
70,37,94,55,0.085062241,26376446174,3/18/20,29160000,416,70,0,486,94,94,43,70,279
76,41,100,55,0.072300469,26396185261,3/19/20,31920000,469,63,0,532,95,100,44,63,325
75,42,72,54,0.076923077,26404954216,3/20/20,32220000,462,75,2,537,95,72,59,75,331
78,44,86,54,0.079100749,26431025224,3/22/20,36780000,511,102,1,613,95,86,32,102,393
78,42,71,53,0.085914086,26442087723,3/23/20,30480000,443,65,0,508,95,71,53,65,319
70,35,39,51,0.078346028,26455233345,3/24/20,27840000,391,73,0,464,96,40,46,73,305
74,40,83,50,0.076481836,26468262285,3/25/20,31800000,453,77,0,530,95,83,86,77,284
77,42,90,52,0.071502591,26479270124,3/26/20,28920000,430,52,2,482,96,91,77,52,262
75,40,73,52,0.081081081,26491432162,3/27/20,29940000,430,69,0,499,92,73,83,69,274
82,45,112,52,0.079934747,26510243451,3/28/20,37620000,547,80,3,627,96,113,95,80,339
79,46,72,53,0.079617834,26517565273,3/29/20,38220000,510,67,0,637,0,72,44,67,394
72,36,48,53,0.069767442,26529747076,3/30/20,27660000,392,69,0,461,95,48,51,69,293